{
    "target": 20000,
    "data": [
        [0, 0, 0, 0, 0],
        [0, 0, 2, 0, 0],
        [0, 0, 4, 0, 0],
        [0, 0, 8, 0, 0],
        [2, 4, 2, 4, 2],
        [4, 2, 4, 2, 4],
        [1, 1, 1, 1, 1]
    ]
}